NO ./textures/north.xpm
SO ./textures/south.xpm
WE ./textures/west.xpm

EA ./textures/east.xpm
C 225, 30, 0
F 200, 0, 0

     11111111111111111111111111111
     10000000000110000000000000001
     10000000011110000000000000001
     10000000000000000000000111001
     10001100000000000000000010001
11111100010000000000000000000000011111
1E000000000000000000000000000000000001
10000000000000000000000000000000000001
10000000000000000011100000000000000001
10000000000000000111110000000000000001
10000000000000000011100000000000000001
11110000000000000000000000000000001111
10000000000000000000000000000000000001
11111111000001111111111111111111111111
       1000001
       1111111
 
1

1111
1001
1111111111111111111111111111111111111111
